▄▄▄▄▄▄▄▄▄▄▄▄▄▄▄▄▄▄▄▄▄▄
█ █   █   █ █ █      █						  
█ █ █ █ █ █ █ █ █ ████
█ █ █   █ █   █ █ ██ █
█   █ ███ █ ███ █ █  █
█████ █     █   █ █ ██
█     █ █████ ███ █ ██
███████ █     █      █
█       █X█████ ████ █
███████ ███     ███  █
█         █ █████   ██
█ █████████ █   █ █  █
█           █ █ █ ██ █
█ ███████████ █ █ ██ █
█             █   ██ █
▀▀▀▀▀▀▀▀▀▀▀▀▀▀▀▀▀▀▀▀▀▀