▄▄▄▄▄▄▄▄▄▄▄▄▄▄▄▄▄▄▄▄▄▄
█ █   █   █ █ █      █						  
█ █ █ █ █ █ █ █ █ ████
█ █ █   █ █   █ █ ██ █
█  ?█ ███ █ ███ █?█  █
█████ █  ?  █   █ █ ██
█?    █ █████ ███ █ ██
███████ █     █      █
█       █X█████ ████ █
███████ ███     ███  █
█         █ █████   ██
█ █████████ █   █ █  █
█  ?        █ █ █ ██ █
█ ███████████ █ █ ██ █
█             █   ██?█
▀▀▀▀▀▀▀▀▀▀▀▀▀▀▀▀▀▀▀▀▀▀